#	#	#	#	#	#	#	#	#
#	G	G	G	G	G	G	G	#
#	G	G	G	X	G	G	X	#
#	G	G	#	G	G	G	G	#
#	G	G	#	G	G	G	G	#
#	G	G	#	#	#	#	G	#
#	G	G	G	G	G	#	G	#
#	G	G	G	G	G	#	G	#
#	G	X	G	G	G	G	G	C
#	G	G	G	G	G	G	G	#
#	#	#	#	#	#	#	#	#
